1
10 10
##########
#S.......#
########.#
####.....#
####.#####
####.#####
####.....#
########.#
#E.......#
##########