8 7 1
S*******
********
********
********
***A#***
********
******##
******DE